3,3,255,0,0,0,0,255,3,3
3,255,255,0,2,2,0,255,255,3
3,255,0,0,3,3,0,0,255,3
255,255,255,3,3,3,3,255,255,255
3,3,255,3,3,3,3,255,3,3
255,255,1,1,1,1,1,1,255,255
255,1,1,0,0,0,0,1,1,255
255,255,255,2,2,2,2,255,255,255
255,255,255,2,3,3,2,255,255,255
2,2,2,2,3,3,2,2,2,2
0,2,2,2,3,3,2,2,2,0
0,0,2,2,3,3,2,2,0,0
0,0,0,255,255,255,255,0,0,0
255,255,255,255,255,255,255,255,255,255
255,255,255,255,255,255,255,255,255,255
255,255,255,255,255,255,255,255,255,255
255,255,255,255,255,255,255,255,255,255
255,255,255,255,255,255,255,255,255,255
255,255,255,255,255,255,255,255,255,255
255,255,255,255,255,255,255,255,255,255
255,255,255,255,255,255,255,255,255,255
255,255,255,255,255,255,255,255,255,255
255,255,255,255,255,255,255,255,255,255
255,255,255,255,255,255,255,255,255,255
0,0,0,0,0,0,0,0,0,0
