255,255,1,1,255,1,255,255,255,1
1,255,1,1,1,255,1,1,1,1
255,1,1,1,1,255,255,255,255,1
255,1,1,1,1,255,255,255,1,255
1,1,1,1,1,255,255,255,1,255
1,1,1,1,1,255,255,1,255,255
1,3,1,1,1,255,255,1,255,255
1,0,1,1,1,255,1,255,255,255
1,3,1,3,1,255,1,255,255,255
1,3,1,3,255,1,1,255,255,255
255,3,2,1,255,1,255,255,255,255
255,255,2,0,255,1,255,255,255,255
255,255,3,0,255,1,255,255,255,1
255,255,0,3,0,1,255,255,255,1
255,3,0,3,0,255,1,1,1,1

